00000000000000000000000000
00000000000000000000000000
00330033003300330033003300
00330033003300330033003300
00330033003300330033003300
00330033003300330033003300
00330033003355330033003300
00330033003355330033003300
00330033003300330033003300
00330033000000000033003300
00330033000000000033003300
00000000003300330000000000
00000000003300330000000000
33003333000000000033330033
55003333000000000033330055
00000000003300330000000000
00000000003333330000000000
00330033003333330033003300
00330033003300330033003300
00330033003300330033003300
00330033003300330033003300
00330033000000000033003300
00330033000000000033003300
00330033000333300033003300
00000000000300300000000000
00000000000300300000000000