00000000000000000000000000
00000000000000000000000000
00033333000000000000333330
00030033000000000000330030
03330000330011110033000003
03000000330011110033000003
33000000331111111133000003
33000000331111111133000003
33000003331155551133300033
33000003331155551133300033
03000033444444444444333333
03333333444444444444333333
00333333555533555533333330
00333333555533555533333330
00003333550033005533333000
00003333550033005533333000
00003333333333333333333000
00003333333333333333333000
33113333335555333333331133
33110000005555000000001133
33111111111111111111111133
33111111111111111111111133
00001111110000001111111100
00001111110333301111111100
00000030000300300000300000
00000030000300300000300000
