00000000005500330033330000
00000000005500330033330000
00033333333300330000000000
00033333333300330000000000
00000030003300333300111111
00000030003300333300111111
00030000000000550011111111
00030000000000550011111111
00030033333355333311113355
00030033333355333311110055
00333333550000330011110003
00000000550000330011110003
03333333005511111111110000
03333333005511111111110000
00000055000011111111113300
00000055000011111111113300
55330011111111551111113300
55330011111111551111113300
03331111111111000000003330
03331111111111000000003330
00331111000000005533333300
00331111000000000033333300
00001111000000000033000300
00001111000333300033000300
00001111000300300000000000
00331111000300300000000000
