00000000000000333333000000
00000000000000333333000000
00333333000000000033000000
00333333330033000033000000
00000000330033000000003333
00000000330000000000003333
00444444444400333000003355
00444444444400333000003300
00000000004400330055503300
00005555554400330055503300
33003333334444440044333300
33003333334444440044333300
00000000003355550044444400
00000000003300000044444400
33333300000000000000000000
33333300000000000000000000
00003300555500000033330003
00003300000000000033330003
33000000000000000033000033
33000000000333300033000033
00000000000300300000000000
00000000000300300000000000
