00000000000000000000000000
00000000330000003300000000
00333333330000003333333300
00333333330000003333333300
00330000000033000000005500
00330000000033000000005500
00550033330000003333003333
00550033000000000033003333
00330030110055001103005533
00330030115555551103005533
00330000111111111100005533
00000000111111111100000033
33000000111111111100000033
33550000111111111100003333
33550030115555551103003300
33550030110055001103003300
33330033000000000033005500
33330033330000003333005500
33550000000033000000003300
33550000000033000000003300
33333333330000003333335555
33333333330000003333335555
33330000330000003300003300
33330000000333300000003300
33330000000300300000000000
33330000000300300000000000
