00000000000000000000000000
11110000003333330000001111
11110000333333333300001111
11000003333333333330000011
11000003333333333330000011
00000033331133113333000000
00000033331133113333000000
00000033111133111133000000
00000033111133111133000000
11000033333333333333000011
11000033333333333333000011
11110000331133113300001111
11110000331133113300001111
44444400333333333300444444
44444400333333333300444444
00000000030303030300000000
00000000030303030300000000
00000000303030303000000000
00000000303030303000000000
05050500000000000000505050
05050500000000000000505050
30303000000000000000030303
30303000000000000000030303
50505005000300300050050505
50505005000300300050050505
