00000000333300003300000000
00000000333300003300000000
00111133330000003300000000
00111133330000003300000000
11111111111111113333000000
11111111111111113333000000
11553311333333111111113355
11003311333333111111113355
11113311111155111133503300
11113311111100111133503300
00111133001111111133003300
00111133551111111133003300
00333333333311113333301111
00333333333311113333301111
05553333000000333300000011
05003333000000330000000011
00330033000000331111333011
00330033005533001111333011
00330000033333111133000011
00330000033300111133000011
00333330033311110011331111
00333330030011113311331111
00003300110000003311331100
00003300110333303311001100
00003300000300300011111100
00000000000300300011111100
