00000000000000000000000000
00000000000000000000000000
00005511550000000000000000
00005511550000000000000000
00000011001100000000000000
00000011001155000000000000
00110000000011000000000000
00111100001100110000000000
00111100001100115500000000
00110011001100001100000000
00110011001100001133000000
00110000110000001111000000
00110000110000001111550000
00001100000000111111110000
00001100000000111111113300
00000011000011001111111100
00000011000011001111111100
33000000000011000011111155
33000000000011000011111155
33330000000000110011111111
33330000000000110011111111
55333300000000001100111111
55333300000333301100111111
55553333000300301100001111
55553333000300301100001111
