00000000000000000000000000
00000000000000000000000000
00330033330000222222333300
00330033330000222222333300
00330000330055222222222200
00330000330055222222222200
22222250330000332222222200
22222250330000332222222200
22222222222233330330000000
22222222222233330330000000
00000522222222330330005555
00000522222222330330000000
33333333222222222222223333
33333333222222222222223333
00000033332222222250000000
00000033332222222250000000
00333333002222223333003300
00333333002222223333003300
22222233220000000033003300
22222233220000000033003300
22222222225500550000003300
22222222220000000000333300
33222222220000000033000000
33222222220333300033000000
33335000000300300033003300
33335000000300300033003300
