00000000000000005555551100
00000000000000005555551100
00330000000000005500005500
00330000000000005500005500
33113300000033333333005500
33113300000033333333005500
00331133000033001133555500
00331133000033001133555500
00003300115533110033000000
00003300115533110033000000
00000000550033553333000000
00000000550033553333000000
00003333553300550000000000
00003333553300550000000000
00003300113355110000000000
00003300113355110000000000
55555511003300003333000000
55555511003300003333000000
55003333333300003355550000
55003333333300003355550000
55000055000000000055333300
55000055000000000055333300
11555555000000000000335555
11555555000333300000335555
00000000000300300000005555
00000000000300300000005555
