00330033003300330033003300
00330033003300330033003300
00330033003300330033003300
00330033003300330033003300
00550055005500550055005500
00000000000000000000000000
00000000330000003300000000
33003300330000003300330033
33003333330033003333330033
33003300330033003300330033
55005500550055005500550055
00000000550000005500000000
11110000330011003300001111
11110000330011003300001111
11111111333311333311111111
11111111330011003311111111
11111111111111111111111111
11111111111111111111111111
00000000331111113300000000
33003300331111113300330033
00330033000011000033003300
00330033000011000033003300
00330033000000000033003300
00330033000333300033003300
00330033000300300033003300
00000000000300300000000000
