00000055000000550000000000
00000055000000550000000000
00330055000000330033003300
00330055000000330033003300
00330000000033330033553300
00330000000033330033553300
00000033000000000055000000
00000033000000000055000000
11000033000055000033113355
11000033000055000033113355
11110000003300005500110000
11110000003300005500110000
00333333111111550000113300
00333333111111550000113300
00000055113300330033003300
00000055113300330033003300
55330055003300330000003300
55330055003300330000003300
00330033003333330033553300
00330033003333330033553300
00330033003333330000000000
00330033003333330000000000
00330000000000000033003300
00330000000333300033003300
00330033000300300033333300
00330033000300300033333300