00000044003300003300330000
00000044003300003300330000
00000000000000003300550000
00000000000000003300550000
00000044000055003300330000
00000044003355003300330000
55003344005500003300330000
00003344005500330000330000
00003344000000330000000000
00003344000000330000000000
33003344440044444444000033
33003344440044444444000033
00000000000000110044005555
00000033000000110044000000
33330333005511111144000000
33330333005511111144003333
33000300003311111144003300
00000300003311111144003300
00000000003300110044001100
00550000003300110044001100
00330000003333330000111111
00330055000000000000111111
00330033000000000044111111
00330033000333300044111111
00000000000300300044001100
00000000000300300044001100
