00000000000000000000000000
00000033333300003300000000
00003333333333333333000000
00333333333333333333000000
00111111111111111133330000
00111111111111111133330000
11110000000000001111333300
11110000000000001111333300
11005500005500000011111100
11005500005500000011111100
11005500005500000011111100
11005500005500000011111100
11000011000000001111333330
11000011000000001111333330
11111111111111111133333330
11111111111111111133333330
33111133331111113333333300
33111133331111113333333300
00333333333333333333330055
00333333333333333333330055
55003355333333333333300055
55003355333333333333300055
00553333550000003333555555
00553300550333303333555555
00000000000300300000000000
00000000000300300000000000
