00000000001100000000000000
00000000001100000000000000
00000000115511000000000000
00000000115511000000000000
00001100001100001111000000
00001100001100001111000000
00113311000000113333110000
00113311000000113333110000
00001133110000001111000011
00001133110000001111000011
11000011000011000000001155
11000011000011000000001155
33110000001155110000110011
33110000001155110000110011
55331100000011000011551100
55331100000011000011551100
33110000110000001100110000
33110000110000001100110000
11000011331100113311000000
11000011331100113311000000
00000011331100001100001100
00000011331100001100001100
00110000110000000000115511
00110000110333300000115511
11551100000300300011331100
11551100000300300011331100
