00000000000000000000000000
00000000000000000000000000
00000000005555000000000000
00000000005555000000000000
00000000000055000000000000
00000000000055000000000000
00555511113355331111555500
00555511113355331111555500
00000055111155111155000000
00000055111155111155000000
11000000551111115500000011
11000000551111115500000011
55110000001111110000001155
55110000001111110000001155
11000000005511550000000011
11000000550011005500000011
00000000550000005500000000
00000000550000005500000000
00000055000055000055000000
00000055000055000055000000
00000000000000000000000000
00000000000000000000000000
00000000000000000000000000
00000000000333300000000000
00005500000300300000550000
00005500000300300000550000
