00005500335500000000030000
00005500330000000000030000
00003300331100333333330000
00003300331100003333330000
00111100331103300000005555
00111100331103300000005555
11111111111133333300033300
11111111111133333300033300
00001111000055330003333303
00001111333300330003330003
33550000333300000033330003
33000033000000000033000003
03000033222222222222222222
03003333222222222222222222
03003300222222222222222222
03000000222222222222222222
00005500222222222222222222
00005500222222222222222222
33003300222222222222222222
33003300222222222222222222
03003300222222222222222222
03003300222222222222222222
03003300000000002222222222
03003300000333302222222222
00003300000300300022222222
00000000000300300022222222
