00000055003300330033005500
00000055003300330033005500
00330033000000000055000000
00330033000000000055000000
00330033000055000055005555
00330033000055000055005555
00330000003300553300000055
00330000003300553300000055
00000000333300333300550000
00000000333300333300550000
00005500330000333300333300
00005500330000333300333300
55005500003300550000553300
55005500003300550000553300
00003333003300000033550000
00003333003300000033550000
00553333003333003333000033
00553333003333003333000033
00330000003355000000003333
00330000003355000000003333
00000033003333550055000033
00000033003333550055000033
33003333000000000033550000
33003333000333300033550000
33003300000300300033333333
33003300000300300033333300
