00004444000000000000000000
00004444000000000000000000
00000044110030000000000000
55000044110030000000000000
11000000000050003000444400
11550000000050003000444400
11110055000300005011440000
11110000330300005011440000
11111100005500030000000000
11111100005533030000000055
11115500000300550000000011
11110055000300553300005511
11550000335500030055001111
11000000005500030000001111
00000000003033550000111111
00000000003000550000111111
00004411050000303300551111
00004411050000300050501111
00444400030005000000000011
00444400030005000000000011
00000000000003001144000055
00000000000003001144000000
55000000000000000044440000
55000000000333300044440000
55550000000300300000000055
55550000000300300000000055
