00000000550000000000000000
00000000550000000000000000
55550000550000555500000000
55550000550000555500000000
00550000550000005500555511
00550000550000005500555511
00550000555555001100550000
00550000555555001100550000
00330000000055005555550000
00330000000055005555550000
11555500553355333300000000
11555500553355333300000000
00005511551100003300005555
00005511551100003300005555
00005500001100005500005500
00005500001100005500005500
00003300005500005555335500
00003300005500005555335500
11555555111133555500335500
11555555111133555500335500
00000033000000001111003300
00000033000000001111003300
00000055000000000011003300
00000055000333300011003300
00000055000300300055003300
00000055000300300055003300
