00000000000000000000055000
00000000000000000000055000
00000000000000000000550000
00000000000055000000550000
00000000000011000033300000
00000000003311330033300000
00000000001111110033300000
00000000551111115533300000
00000000111122111133300000
00000033111122111133300000
00000011112222221111300000
00005511112222221111300000
00001111222222222211110000
00331111222222222211113300
00111122222222222222111100
55111122222222222222111155
11112222222222222222221111
11112222222222222222221111
00112222222222222222221100
00112222222222222222221100
00112222222222222222221100
00112222222222222222221100
00112222220000002222221100
00112222220333302222221100
00112222000300300022221100
00112222000300300022221100
