00000000000000000000330000
00000000000000000000330000
00334444005500330000000000
00334444005500330000000000
00004444331111114444005500
00004444331111114444005500
00000000001111114444330000
00000000001111114444330000
00550000444400110000000000
00550000444400110000000000
11113300444455000000003300
11113300444455000000003300
11111100000000000055000055
11111100000000000055000055
00334444003300000000000000
00334444003300000000000000
55004444111144441111003300
55004444111144441111003300
00000000110044441111444400
00000000110044441111444400
00000055110000001111444400
00000055110000001111444400
00003300330000000000000000
00003300330333300000000000
33000000000300300033550000
33000000000300300033550000
