00000000330000003300000000
00000000330000003300000000
00111111330000000000000000
00111111330000000000555555
33111111000000000000000000
33111111000000000000000000
11111111000000330033333330
11111111000000330033333330
11111111333333330033000300
11111111333333000033000300
11111111000033000000000300
11111111000033000000000300
00110000000055555500001100
00110000000055555500001100
00000000000000000011111111
00330033000000000011111111
33300333300333333311111111
33300333300300000011111111
00000000003300000011111111
00000000003300333311111111
33000050000000333311111100
33000050000000000011111100
33330050000000000011111100
33330050000333300011111100
55333300000300300033000000
55333300000300300033000000
