00000000000000000000000000
00000000000000000000000000
00000000003333000000550000
00000000001111000000110000
00555500331111550033113300
00111100111111110011111100
33111133111111113311111133
11111111111111111111111111
11111111111111111111111111
55114411111111114411111111
55114411111111114411111111
11114444441111114444441155
11114444441111114444441155
11111111441155111111441111
11111111441155111111441111
11111111111111111111111111
11111111111111111111111111
11111111113333111111111155
11111111110000111111111100
55111111330000331111115500
00111111000000001111110000
00553333000000003333330000
00000000000333300000000000
00000000000300300000000000
00000000000300300000000000
