00000044000000004400000000
00000044000000004400000000
44440044004444444400444444
44440044004444444400444444
11113300003300004400441144
11113300003300004400441144
11444444440055000033111111
11444444440055000033111111
11110044000044004444444411
11110044000044004444444411
44440044004444000044000000
44440044004444000044000000
00003311330033110044000044
00003311330033110044000044
00444411444444440011330044
00444411444444440011330044
33000033000044001111440044
33000033000044001111440044
44440044440044334444440000
44440044440044334444440000
00003300111100001144000044
00003300111100001144000044
00444444110000000044004444
00444444110333300044004444
00440000000300300000000000
00440000000300300000000000
