22222222222200222222222222
22222222222200222222222222
22222222222222222222222222
22222222222222222222222222
22222233222222222233222222
22222233222222222233222222
22330033003322330033003322
22330033003322330033003322
22333333000000000033333322
22000033000000000033000022
22222233003355330033222222
22222233333355333333222222
55222222005500550022222255
55222222000000000022222255
22222222003300330022222222
22222222003300330022222222
22222222003300330022222222
22222222003300330022222222
22222233000000000033222222
22222233000033000033222222
22332233005555550033223322
22332233000000000033223322
00330033000000000033003300
00333333000333300033333300
00330000000300300000003300
00000000000300300000000000
