00000000550000000055000000
00000000550000000055000000
00550000005500005511110000
00550000005500005511110000
00005500000000551100500000
00005500000000551155500000
00000055001111111111000500
00000055001111111111000500
00500000551111551100005500
00550000551111551100005500
00555011005511115511110500
00005011005511115500000500
00001111111111000055000000
00001111111111000055000000
00005011005511000000550000
00555011005511000000550000
00111111550055000000005500
00111111550055005500005500
11111155000000000500000000
11111155000000000000000000
00005500000000000000000555
00005500000000000000000555
00000000000000000000500000
00000000000333300055500000
50000000000300300000000000
50005500000300300000000000
