00000000300300000000000000
00000000300300000000000000
30303003003000003030000000
30303003003000003030000000
30303033330000003030000000
30303033330000003033300000
03030033300000033033330000
03030033300000033033330000
00300033033000303333330000
00300033033000303333330000
00300300003330330303330000
00300300003330330303330000
00300000033333300030330000
00300000033333300030330000
00030000303333300030330000
00030000303333300030330000
00033333003333330030303333
00030000003333330030300033
00030000033033033030300303
00030000033033033030300303
00003000330330333300000300
00003000330330333300000300
00003003300000003330003000
00003003300333303300030000
00003003000300300033330000
00003003000300300033330000
