00000000000000000000000000
00000000000000000000000000
00000000330033000000000000
00000000330033000000000000
11000011331133110000110000
11000011331133110000110000
33111133333333331111331100
33111133333333331111331100
33333333553355333333331100
33333333553355333333331100
44444433333333334444441100
44444433333333334444441100
44333333333333333333444411
44333333333333333333444411
33333344333333443333331111
33333344333333443333331111
33334444443344444433334444
33334444443344444433334444
11444411111111114444114411
11444411111111114444114411
00111100000000001111001100
00111100000000001111001100
00000000000000000000000000
00000000000333300000000000
00000000000300300000000000
00000000000300300000000000
