00111100000000000000001100
00111100000000000000001100
11110000003333000000000011
11110000333333333300000011
11000003333333333333000055
11000003333333333333330000
55000033333333333333333000
00000033333333333333333000
00000333000000333333003000
00000300000000003333003000
44000300500050003330000000
44000300500050003330000000
00003300000000003330004444
00003300333300003330004444
00003333333333333333000000
00003333333333333333000000
00033333333333333333300000
00033333333333333333300000
00333333333333333333330000
00000033333333333300000000
00333300333333330033330011
00333333003333003333330011
11003333000000003333001111
11000000000333300000001111
55110000000300300000111155
55110000000300300000111155
