00000000000300301111000000
00000000000300301111000000
00300500300000000311300311
00300500300000000311300311
00300500300033000311300311
00300500300033000311300311
00330000330055003311003311
00330000330055003311003311
00000003550033003350001111
00000003000033000050001111
33333000001133110000033333
33333000001133110000033333
00000000031111113000000000
00000000031111113000000000
55333300331111113303333355
55333300001111110003333355
55555500000011000000555555
00000000330011003300000000
00330000330000003300000000
00330000330000003300000000
00333000003300330000033311
00333000000000000000033311
00003300000000000000111111
00000000000333300000111111
00000000000300300000001111
00003300000300300000331111
