00000000000000555500000000
00000000000000000000000000
00005555555500000000550000
00005500000000000000550000
00005500000011005555550000
00005500000011000055550000
00550000001155000000550000
00550000001155000000550000
00000000115555000000555500
00000000115555000000005500
00550011555555005500000000
00550011555555005500000000
00050055550000005555000000
00050055550000005555000000
50000000550055555500000500
50000000550055555500000500
00055500000055551100005500
00055500000055551100005500
00550000000055110000555500
00550000000055110000555500
00555555000011000055000000
00000055000011000055000000
00000000000000000055000055
00000000000333300000005555
00000000000300300000000000
55550000000300300000000000
