00003300003300000033000000
00003300003300330033000000
11333333003300000033300000
11333333003300550033300000
11111100003300330033000330
11111100000000330000000330
11444444444444444444440044
11444444444444444444440044
00330000000000000000000000
00330000000033330000000000
00003300000333333333335555
00003300000333330033000000
33330033000333331133000033
33330033000333331133555533
00000055000000111111110000
00000055005500111111110000
44440044444444440044444444
44440044444444440044444444
11110003000000000000000000
11110003000033330000000000
11113300300000030000003300
11113300300000030055333300
11003300300000000033003300
00553300300333300000003300
00000000000300300000003300
00000000000300300033000000
