00000033000000000000110000
00000033000000000055110000
33000000000000110555500033
33000000000055110555500033
00000000110555500055110000
00000055110555500000110000
00000555500055110000000000
00000555500000110000000000
00000055110000000000000000
00000000110000000000000000
00000011001100110011000000
00000011551100115511000000
55330005555000055550003355
55330005555000055550003355
00000011551100115511000000
00000011001100110011000000
00000000000000000000000000
00000000550000005500000000
33000005555000055550000033
33000005555000055550000033
33000011551100115511000033
33000011001100110011000033
00000000000000000000000000
00003300000333300000330000
00003333000300300033330000
00003333000300300033330000
